W;W;W;W;W;W;W;W;W;W
G;G;G;P;G;S;G;G;G;W
G;G;G;P;G;W;G;G;G;W
G;W;S;G;G;W;G;G;G;W
G;W;G;G;G;P;G;SC18;G;W
G;W;G;G;G;P;G;W;D;W
G;W;G;G;G;P;G;W;G;W
SS;W;G;G;G;P;G;W;G;W
SS;W;G;G;G;P;G;S;G;W
W;W;W;W;W;W;W;W;W;W
